                                         
                                         
                                         
                                         
                                         
                                         
              *           *              
                                         
                                         
                                         
                  #####                  
                  #####                  
                  #####                  
                  #####                  
      *           #####           *      
                  #####                  
                  #####                  
                  #####                  
          #####################          
          #####################          
          #####################          
          #####################          
          #####################          
                  #####                  
                  #####                  
                  #####                  
      *           #####           *      
                  #####                  
                  #####                  
                  #####                  
                  #####                  
                                         
                                         
                                         
              *           *              
                                         
                                         
                                         
                                         
                                         
                                         